2 2 2 2 9 10 2 2 2 3 2 2 2 2 2 2 2 2 2 2 2 2 2 2 2
2 0 0 0 23 0 1 5 0 0 6 6 2 0 21 33 26 27 26 26 0 25 0 0 2
2 0 0 0 0 0 0 0 0 0 7 7 2 0 0 0 0 0 0 0 0 0 0 0 2
2 22 0 0 0 0 0 0 0 0 8 8 2 0 0 0 0 0 0 0 0 0 0 0 2
2 0 0 0 0 0 0 0 0 0 0 0 2 0 0 0 0 0 0 0 0 0 0 0 2
2 0 0 0 0 0 0 0 0 0 0 0 2 0 0 0 0 0 0 0 0 0 0 0 2
2 0 0 0 0 0 0 0 0 0 0 0 2 0 0 0 0 0 0 30 31 32 0 0 2
2 0 0 0 0 0 0 0 0 0 0 0 2 0 0 0 0 0 0 0 0 0 0 0 2
2 0 18 0 0 0 0 0 0 0 0 25 2 0 0 0 0 0 0 0 0 0 0 0 2
2 2 2 2 0 0 0 0 2 2 2 2 2 2 2 2 2 0 0 0 2 2 2 2 2
2 29 29 0 0 0 0 0 0 28 0 0 2 12 12 25 0 0 0 0 13 14 15 16 2
2 0 0 0 0 0 0 0 0 0 0 0 2 11 11 0 0 0 0 0 0 0 0 0 2
2 0 0 0 0 0 0 0 0 0 0 0 0 0 0 0 0 0 0 0 0 24 17 0 2
2 0 0 0 0 0 0 0 0 0 0 0 0 0 0 0 0 0 0 0 0 0 0 0 2
2 0 0 0 0 0 0 0 0 0 0 0 0 0 0 0 0 0 0 0 0 0 0 0 2
2 19 0 0 0 0 0 0 0 0 0 0 2 0 0 0 0 0 0 0 0 0 0 0 2
2 0 0 0 0 0 0 0 0 0 0 0 2 0 0 0 0 0 0 0 0 0 0 0 2
2 0 0 0 0 0 0 34 0 0 25 0 2 4 0 0 0 0 0 20 0 0 0 0 2
2 2 2 2 2 2 2 2 2 2 2 2 2 2 2 2 2 2 2 2 2 2 2 2 2